w,w,w,w,w,w,w,w,w,w,w,w,w,w,w,w,w,w,w
w,p1.1,p1.2,p1.3,p1.4,p1.5,.,w,.,.,.,w,.,p2.1,p2.2,p2.3,p2.4,p2.5,w
w,.,.,.,.,.,.,ax,.,.,.,ax,.,.,.,.,.,.,w
w,.,w,az,w,w,w,w,b,b,b,w,w,w,w,az,w,.,w
w,b,b,.,.,.,.,b,.,.,.,b,.,.,.,.,b,b,w
w,b,b,.,.,k,.,b,.,k,.,b,.,k,.,.,b,b,w
w,b,b,.,.,.,.,b,.,.,.,b,.,.,.,.,b,b,w
w,.,w,w,az,w,w,w,b,b,b,w,w,w,az,w,w,.,w
w,.,.,.,.,.,.,ax,.,.,.,ax,.,.,.,.,.,.,w
w,p3.1,p3.2,p3.3,p3.4,p3.5,.,w,.,.,.,w,.,p4.1,p4.2,p4.3,p4.4,p4.5,w
