p1.1,p1.2,p1.3,p1.4,p1.5,.,.,.,.,.,.,p2.1,p2.2,p2.3,p2.4,p2.5
.,.,.,.,.,.,rd,rd,rd,rd,.,.,.,.,.,.
.,rr,w,w,w,az,w,w,w,w,az,w,w,w,rl,.
.,rr,w,w,w,az,w,w,w,w,az,w,w,w,rl,.
.,rr,w,w,w,az,w,w,w,w,az,w,w,w,rl,.
.,rr,w,w,w,az,w,w,w,w,az,w,w,w,rl,.
.,rr,w,w,w,az,w,w,w,w,az,w,w,w,rl,.
.,.,.,.,.,.,ru,ru,ru,ru,.,.,.,.,.,.
p3.1,p3.2,p3.3,p3.4,p3.5,.,.,.,.,.,.,p4.1,p4.2,p4.3,p4.4,p4.5
