.,.,.,.,k,g0,w,w,w,w,g0,k,.,.,.,.
.,.,.,.,.,g0,w,w,w,w,g0,.,.,.,.,.
.,.,.,.,.,g0,w,w,w,w,g0,.,.,.,.,.
.,.,.,.,.,g0,w,w,w,w,g0,.,.,.,.,.
.,.,.,.,.,w,g0,w,w,g0,w,.,.,.,.,.
.,.,.,.,.,.,.,ru,ru,.,.,.,.,.,.,.
.,.,.,.,.,.,.,.,.,.,.,.,.,.,.,.
.,.,.,.,.,.,.,.,.,.,.,.,.,.,.,.
.,.,.,.,.,.,.,.,.,.,.,.,.,.,.,.
