w,w,w,w,w,w,rl,.,.,rr,w,w,w,w,w,w
g0,.,.,.,.,.,.,.,.,.,.,.,.,.,g0,w
.,.,.,.,.,.,.,.,.,.,.,w,w,w,w,w
w,w,e3,w,w,w,w,.,w,,e3,w,.,w,w,w
w,w,h,w,w,w,w,.,w,g0,g0,w,.,e1,g0,w
w,w,e1,g0,w,w,w,.,w,w,w,w,.,g0,g0,w
g0,.,.,.,.,.,.,.,g0,.,.,.,.,w,w,w
g0,.,.,.,.,g0,.,.,.,.,.,g0,w,w,w,w
w,w,w,w,w,w,rl,.,.,rr,w,w,w,w,w,w
